11111111111
10100000101
10011001101
101010C0C01
1PC1000C1C1
10000E00001
11111111111
