1111111111111111
100C001C00000C11
10010C01EC100011
11010000000100P1
1111111111111111
