11111111111111
111011C00000P1
111100110C0001
100C0C100C0C01
10000000000001
10000000E00001
11111111111111
