11111111111111
100CCC11C10001
10001100010001
10P00000010E01
11111111111111
