111111
11C0C1
1C0C11
100001
100001
10PE01
101001
110001
110001
100001
111111
