111111111111
11C1C11C10C1
10001000E001
100P10000101
111111111111
