1111111
1000P01
1000C11
11011C1
1100001
11C0001
1C01111
1001001
1000E01
1111111
