111111111111
10CCC0C00101
1010E110C101
1010C1000001
1000CCC00001
11C000100001
1111110P0001
111111000001
110101000001
110101000001
100000000001
100000000001
111111111111
