1111111111111111
1C01CC001CC000C1
1C01100C01C11C01
110CC0C0C0110001
1000000000000001
1000000000000001
1000000000000001
1000000000000001
10000000000E0001
10P0000000000001
1000000000000001
1000000000000001
1000000000000001
1111111111111111
