11111111
10100001
100CC111
10C00001
110C0C11
100P1001
10101111
10101111
10000001
100E0011
11111111
