1111111111
100C0000C1
1001C00C11
1CC1CC0001
1000110001
1000000011
1010000001
10000E0P01
1001000001
1110000001
1000000001
1111111111
