111111111111111
100C0101C011001
1C1CC0110C00001
1C011C100C00CC1
1000C0000000001
100000000000001
10000E00000P001
100000000000001
100000000000001
100000000000001
100000000000001
111111111111111
