111111111111
11001001C011
10C110C100C1
10C000001011
10E10P000001
100000000001
111111111111
