11111111111111
11010100000001
11C011CC0C0001
1C1CP0000CC1C1
1C110C00C00C01
100C0000000001
10000000000001
10000000000001
10000000000001
10000000000001
10000000000001
10000000000001
10000000000001
100000000E0001
11111111111111
