1111111
1010001
100CC11
10C0001
110C0C1
100P101
1010111
1010111
1000001
100E001
1111111
