11111111111
1CC01100001
101CP000001
11000000101
1C01CCCC1C1
1C001E00011
10010000001
10000000001
10000000001
10000000001
10000000001
10000000001
10000000001
11111111111
