1111111111
1011C11C01
1011CCP101
1001010101
10000E0001
1111111111
