111111111111
100101001101
10001CC1C001
1001000101C1
1001C0C00001
10C00C0C0P01
1C00000C0001
100000000001
100000000001
100000000001
100000000001
100000000E01
100000000001
111111111111
