111111111
10C10C111
10C110001
1PC000001
100C101C1
10001C001
100101001
100000001
100000E01
100000001
100000001
111111111
