11111111111111111
100CE0C0010001001
111C00C1110C0C001
10001000000011001
100P00000C0000001
11111111111111111
