11111111111
100C0100C01
100C1000111
10100C00CC1
11C0C0C0001
111CC1C0101
10000000001
10000000001
10000000001
100000P0001
10000000001
10000000001
10000000001
100E0000001
10000000001
10000000001
11111111111
