11111111
1100CC01
11C0CC11
10P10001
1E01C001
11011001
10001011
10000001
10000001
10000001
10000001
10000001
11111111
