111111
1P0E01
1001C1
111C11
111111
