111111
10C1C1
1100C1
1CCC01
110011
101001
110011
110011
101001
100001
1E0001
100001
100001
100P01
100001
100001
111111
