111111
1C00C1
110CC1
100101
100001
100E01
1P0001
111101
101001
111111
