1111111111
10P01CE101
100000C0C1
100010C001
11CC010CC1
1010010001
1000101001
1000100001
1000000001
1000000001
1000000001
1111111111
