11111111111111
1101CE011CCC01
1CCP00CC000011
11100C01000001
100000110C0001
1000C000000001
10000000000001
10000000000001
10000000000001
10000000000001
10000000000001
11111111111111
