1111111111
10010C0001
1010001001
10C0C0C1C1
100C0CC101
111100C001
1100000001
100001E001
1000000001
1000000001
10000P0001
1000000001
1000000001
1111111111
