1111111111111111
1110C00101CC0101
11C001CC000C0C01
1001100000000001
10P0100000000001
1E00000000000001
1000000000000001
1111111111111111
