11111111111111
111C1C0100CCC1
100000E0C00C01
10C01000010001
10000000011011
10000100000001
10000000000001
1000000P000001
11111111111111
