11111111111
11CC0001101
10PC0101001
101001E0001
11111111111
