11111111111111
111000C0010CC1
1100001CCC0001
10C000CC011011
1C011E00C0C001
1000C0C0000001
10000000000001
10000000000001
10000000000001
1000P000000001
10000000000001
10000000000001
10000000000001
10000000000001
10000000000001
11111111111111
