111111111111111111111111111111111111
100CE0C1P100C00001000100001000000001
111C0MC10C000000011111000000000M00C1
1000100000100000000000011001000M0001
1000000000000MC001111111CM0100000001
111111111111111111111111111111111111
