111111111111111
11P1001011C00C1
1CC00C00C1000C1
11C1001001CCC01
1C0000000000001
100000000000001
100000000000001
100000000000001
1000000000E0001
100000000000001
100000000000001
111111111111111
