1111111111111
11PC011C0C001
1C01010000001
1011000010001
1111111111111
