111111
100001
1ECC01
100001
11C011
100001
1P0011
101001
111111
