1111111111111111
10010C010000C0C1
100C010C01000011
10100CC0C0001011
100100C010000C01
100000C000000001
1000000000000001
1000000000000001
1000P00000000001
100000E000000001
1111111111111111
