111111111
1101E11P1
1C0000001
100C00C01
10C001001
110100001
111111111
