11111111111
10100000111
1100C000101
1C010CC1101
100CC010011
10C0C000001
10000000001
100000000E1
100P0000001
10000000001
10000000001
11111111111
