111111111111111
1011000CC0C00C1
10C0C0011010001
1001C100CC00101
1100C010000CC01
1C0000000C0C0C1
1C00000000P0001
100000000000001
100000000000001
100000000000001
100000000000001
100000000000001
100000000000001
10E000000000001
100000000000001
100000000000001
111111111111111
