11111
1C001
1C1C1
10CC1
11001
11P01
10E01
10001
11001
10001
11001
11111
10001
10011
11111
