1111111111
1C11100011
1CC10C0001
10CC0C0001
1010101011
1100000001
100E000001
100P000001
1000000001
1000000001
1111111111
