1111111
101C011
1110E01
10100P1
1000001
1111111
