11111111
10000111
1100C011
10CC1001
1C0C1001
10P110E1
10000001
10101001
10000001
10000001
11111111
