1111111
1E0P001
10001C1
1000001
10C1001
1111111
