111111111
10011CE01
1P00000C1
101100001
10000C001
111111111
