1111111111
1CC0001001
1000CC1C01
1C1CC11101
11C0000001
1E00001011
1100000001
1000000001
1000000001
1000000001
100000P001
1000000001
1000000001
1111111111
