111111111111111111
101C1101C010000001
100011C0E001000001
1000P0C00000000001
101C11011111110001
101C11011111100001
101C11001111000011
101C11001110000011
101C11001110000001
111111111111111111
