111111
101CC1
110001
1C0011
1CE101
100001
101001
100001
1000P1
101101
111111
