111111111111111
1C001EC001000P1
10C11CC01001001
110010000001101
111111111111111
