111111
110C11
1C0101
1P0001
111111
