11111111
10001C11
10C00011
11C00111
10C0P0C1
10C00001
10000001
10E00101
10001001
10011001
10000001
11111111
