1111111111
1111C11011
1011010001
1100000001
100000CC01
100CC000P1
1CC0000001
1000C00C01
1000000001
1000000001
1000000001
1000000001
100000E001
1111111111
