111111111111111
1P01111C00EC0C1
11C01000001C011
100000C01100C01
100000000000001
100000000000001
111111111111111
