1111111111111111
100010CC10EC0101
1C10C0PC0000C101
11C1C01001100001
1000000000000001
1000000000000001
1000000000000001
1000000000000001
1111111111111111
