111111111111
100C0010CC11
1000P01001C1
10C1C00EC001
111100000001
110100000001
100000000001
100000000001
111111111111
