1111111111111
1C00C01001101
10C000CE00001
11000P1000001
1111111111111
