111111111111111
100C11011C00001
10000C1CC111E01
1C00001C0CCC101
1C00C0C0C000001
100C0C000000001
100000000000001
100000000000001
100000000000001
10000P000000001
100000000000001
100000000000001
100000000000001
100000000000001
100000000000001
111111111111111
