1111111111111
11C0C01C1C011
1111101001C11
11010C00P0001
1000000000001
1000E00000001
1111111111111
