111111111111111
10010000100CC01
1010C110CP10C01
10C0C1111C00001
100C0C000000CC1
100C0C000000001
100000000000001
100000000000001
100000000000001
1000000000E0001
100000000000001
100000000000001
100000000000001
111111111111111
