111111111111111111111111111111111111
100CE0C1P100C00001000100001000000001
111C00C10C000000011111000000000000C1
100010000010000000000001100100000001
10000000000000C001111111C00100000001
111111111111111111111111111111111111
