111111111
1100CCC11
1010C0C01
1C0CCC111
110000001
100110001
100010001
1P1000001
100000001
100000001
100000001
100000001
100E00001
100000001
100000001
111111111
