1111111111111111
1000000C110CC1C1
1C1000C00C000001
1101010100000111
1000000000000001
100P00E000000001
1111111111111111
