1111111111111111111111111111111111
1100000000000000000000000000000001
1010000000000000000000000000000001
1010000000000000000000000000000001
1100000000000000000000000000000001
1C0C100000000000000000000000000001
1100C00000000000000000000000000001
100E000000000000000000000000000001
100C000000000000000000000000000001
1010C00000000000000000000000000001
10P1000000000000000000000000000001
1000C00000000000000000000000000001
1000000000000000000000000000000001
1011000000000000000000000000000001
1000000000000000000000000000000001
1111111111111111111111111111111111
