111111111111
100101100001
1001CC1C0CC1
100000000101
1E000000P001
101011010001
111111111111
