1111111
10PC1C1
11000E1
1100001
1111111
