1111111111111111111111
100CE0C00100P100C00001
111C00C1110C0CM0000001
1000100000001100000001
1000000000000000000001
1000000M00000000000001
10000000000CC000000001
10000000000M0000000001
1000M000C00000C0000001
1000000M00000000000001
1000000000000000000001
10000000000000C0000001
100000000000C000000001
1000000000000000000001
1111111111111111111111
