111111
1000C1
1100C1
111011
11C001
1001C1
1CE101
111001
100001
110001
100001
1P0001
100001
111111
