111111111
10P101C11
1100C10C1
111CCC011
1001001C1
100000001
100000001
1E0000001
100000001
100000001
100000001
111111111
