11111111111111
100CE0C1P100C1
111C00C10C0001
10001000001001
10000000000001
11111111111111
