111111111111
1000000011C1
11010C010001
1111CE00C001
1000000C1001
110000000P11
111111111111
