111111111111
1CCC00001011
1CC0110C0001
11C00000C001
100000100001
101100E01001
100000010001
100000000001
10P000000001
111111111111
