111111111
1111010C1
110E0C0C1
110100111
10C001001
100000001
1P0000001
111111111
