111111111
110CCCC01
1000C1011
100001EC1
100000001
101000001
1010010P1
110010001
100010001
100000001
111111111
