111111
110P01
110CC1
1C0C11
10CC01
100011
100001
100E01
110101
101001
100101
100001
101001
101001
111111
