111111111
10C110P01
1010E0101
10C010101
100100C01
1C011C1C1
1C0000001
100000001
100000001
100000001
100000001
100000001
111111111
