111111111
11100C101
11C101011
10P0C0E11
100000111
111111111
