1111111111111111
1011CC00001C0001
10C00C1C01010CC1
10CC011100100001
1C00E000CC0C0001
1C0000000C000001
1000000000000001
1000000000000001
1000000000000001
1000000000000001
1000P00000000001
1000000000000001
1000000000000001
1000000000000001
1111111111111111
