111111
10CC01
101C01
1PC101
100101
110111
110101
100001
100E01
111111
