11111111111111
1CP10011110001
100C0C10C00101
1C000010000001
10000000000011
1010CC000C0001
10000E0000C001
1C000000000001
10000000000001
10000000000001
11111111111111
