111111
10C101
1C0C01
1101P1
1100C1
1000C1
100C11
100001
110001
110001
101101
110001
100001
100001
1E0001
111111
