1111111111
10CC0C0CC1
1C1101C111
100CCC00E1
1000000011
1100000001
1000000001
1110010001
1000000001
1P00000001
1000000001
1000000001
1000000001
1000000001
1000000001
1111111111
