1111111111111111
100CE0C1P100C001
111C00C10C000001
1000100000100001
10000000000000C1
1111111111111111
