111111111
100111001
10001C001
101000C01
10011ECC1
11C0C0001
100000011
1010000C1
100000001
10000C0C1
100000C01
100000001
100000001
100000001
100000001
1000P0001
111111111
