11111111111
100CC0C0001
100E1000111
11C00C010C1
110C100C001
11C10CC0001
10000000101
10000000001
10000000001
10000000001
10000000001
10000000001
10000000001
10000000001
1000P000001
11111111111
