11111111
10001101
10100E11
1CC00011
1101C101
1110C001
10000001
1CCCC001
10000001
1000P001
10000001
10000001
10000001
10000001
10000001
11111111
