1111111111
1010000C01
1CC0101C01
1P0C100111
101000E001
1001010101
1000000001
1111111111
