1111111111
11C00CC001
11C0C01111
100010C0C1
111CE00001
1100001001
1000000P01
1000000001
1000000001
1000000001
1000000001
1111111111
