1111111111
10100C1101
100C1001C1
10EC000001
110CC1CC01
1000000101
1100000001
1000000011
100000P001
1000000001
1000000001
1111111111
