11111111111
101100C00C1
1C1E1C10CP1
1C100010001
10001011001
10000000001
10000000001
10000000001
11111111111
