1111111111111111
100000C0C00P0001
1000100C00000101
111C10CC0C011101
10C1000100000001
1000000000000E01
1000000000000001
1111111111111111
