1111111
1100001
1000C11
11C0001
101C101
1C0P101
11C0001
1001001
1000C01
100C101
1100001
1000001
1000001
1000001
1E00001
1111111
