111111
110001
100001
1C0E11
10C001
101101
1010P1
101001
101001
1C0011
11C1C1
100001
100001
111111
