111111111111111
100CE0C1P100C01
111C00C10C00001
100010000010001
100000000000001
111111111111111
