1111111111111111
10100C1P00000001
1C1100C000000C01
10110C0000100C01
1000000111000E01
1111111111111111
