1111111
10CCC11
10C1001
1C11011
1C00101
1011101
1010001
1000001
1000001
100EP01
1000001
1000001
1000001
1111111
