11111111111111
1C0001000101C1
10C00C100010C1
1C1001C00C10C1
101C01C0CC0C01
10000000000001
1000000000P001
10000000000001
1000000000E001
10000000000001
10000000000001
10000000000001
10000000000001
10000000000001
11111111111111
