111111111
1C11000P1
100C00001
1000CC011
110000001
1010E1001
111111111
