1111111111111111
11C0010100000C11
1CEP0000110C1C01
1C001C0C00000111
1000000000000001
1000000000000001
1000000000000001
1111111111111111
