1111111111
10C0000001
100C010CC1
10101100P1
1C10101C01
1E0000C011
1C01001001
1000000001
1000000001
1000000001
1000000001
1000000001
1111111111
