1111
1EC1
1P01
1011
1001
1C01
1101
1111
