1111
10P1
1101
1C01
1111
1001
1001
1001
1E11
1001
1111
