1111
1011
1011
1001
1001
11C1
1111
1E11
1P11
1C01
11C1
1111
