11111111
1000P001
1E110001
110C0011
1111111
11111111
