11111
1C001
111C1
100C1
10EP1
1C001
10101
10011
10101
10101
11011
10101
10001
11111
