11111
10001
1CC01
1C001
10001
11C01
1P001
100E1
10001
10111
1C111
10001
10001
10011
10101
11001
11111
