1111011111
1000001001
1001100101
1001010011
1010001011
1111111111
