1111111
1101101
10000C1
1000011
1C011C1
110C011
1C1C101
1000001
1P00C01
1000001
1000001
1000001
1000001
10000E1
1000001
1000001
1111111
