1111111
1C011C1
1C01101
11C10P1
1000111
1000001
1000001
1E00011
1000101
1111111
