111111111
110C1C001
101001001
1C0101101
1C0110C01
11000C001
10000C001
10C0C00E1
100000001
100000001
100000001
100000001
1000P0001
100000001
100000001
111111111
