1111111
110E101
1011101
10PC101
10C0001
1111111
