111111111
1101000C1
10011CC01
1E1C1C1C1
101CC0001
110000001
100000101
100000001
10000P001
100000001
100000001
100000001
100000001
111111111
